11111111111111111111111111111111111111111
100000C00CC0000000000000000000000000E0011
100000C00CC000000000000000000000000000011
100000C00CC000000000000000000000000000011
100000C00CC000000000000000000000000000011
100000C00CC000000000000000000000000000011
100000C00CC000000000000000000000000000011
100000C00CC000000000000000000000000000011
100000C00CC000000000000000000000000000011
100000C00CC000000000000000000000000000011
100000C00CC000000000000000000000000000011
100000C00CC000000000000000000000000000011
100000C00CC000000000000000000000000000011
100000C00CC000000000000000000000000000011
100000C00CC000000000000000000000000000011
100000C00CC000000000000000000000000000011
100000C00CC000000000000000000000000000011
100000C00CC000000000000000000000000000011
100000C00CC000000000000000000000000000011
100P00C00CC000000000000000000000000000011
10000000000000000000000000000000000000011
11111111111111111111111111111111111111111