1111111111111111111111111111111111111111
100000C00CC0000000000000000000000000E001
100000C00CC00000000000000000000000000001
100000C00CC00000000000000000000000000001
100000C00CC00000000000000000000000000001
100000C00CC00000000000000000000000000001
100000C00CC00000000000000000000000000001
100000C00CC00000000000000000000000000001
100000C00CC00000000000000000000000000001
100000C00CC00000000000000000000000000001
100000C00CC00000000000000000000000000001
100000C00CC00000000000000000000000000001
100000C00CC00000000000000000000000000001
100000C00CC00000000000000000000000000001
100000C00CC00000000000000000000000000001
100000C00CC00000000000000000000000000001
100000C00CC00000000000000000000000000001
100000C00CC00000000000000000000000000001
100000C00CC00000000000000000000000000001
100P00C00CC00000000000000000000000000001
1000000000000000000000000000000000000001
1111111111111111111111111111111111111111