1111111
10000E1
100CCC1
1000001
1111111