1111
1CE1
1dd1
1001
1P01
1111
