1111111
1000001
100CCC1
1P00001
1111111