1111111
10000E1
100CCC1
1P00001
11111111